41111112200000000000211120000002
11111111220000000002211120000002
11111111120000000002111120000002
11111111122000000002111120000002
11111111112000000002111120000002
11111111112200000022111120000002
11111111111200000021111120000002
11111111111220000021111120000002
11111111111120000021111120000002
11111111111120000021111120000002
11111111111120000221111120000002
11111111111122000211111120000002
11111111111112002211111120000002
11111111111112022111111120000002
11111111111112221111111120000002
11111111111111111111111120000002
11111111111111111111111120000002
11111111111111111111111120000002
11111111111111111111111120000002
11111111111111111111111120000002
11111112222111111111111120000002
11111122002111111111111120000002
11111120002111111111111120000002
11122222002111111111111120000002
