41220000000002111111111120000002
11120000000022111111111120000002
11122000000221111111111120000002
11112000002211111111111120000002
11112000022111111111111120000002
11112000021111111111111120000002
11112000221111111111111120000002
11112000211111111111111120000002
11112000211111111111111120000002
11122000211111111111111120000002
11120000211111111111111120000002
11220000211111111111111120000002
12200000211111111111111120000002
12000000211111111111111120000002
22000000211111111111111120000002
00000000211111111111111120000000
00000000211111111111111120000000
00000000211111111111111120000000
00000000211111111111111120000000
00000000211111111111111120000000
00000000221111111111111120000000
00000000021111111111111120000000
00000000021111111111111120000000
22200000021111111111111120000002
