41111111111111111111111120000002
11111111111111111111111120000002
11111111111111111111111120000002
11111111111111111111111120000002
11111111111111111111111120000002
11111111111111111111111120000002
11111111111111111111111120000002
11111111111111111111111120000002
11111111111111111111111120000002
11111111111111111111111120000002
11111111111111111111111120000002
11111111111111111111111120000002
11111111111111111111111120000002
11111111111111111111111120000002
11111111111111111111111120000002
11111111111111111111111120000002
11111111111111111111111120000002
11111111111111111111111120000002
11111111111111111111111120000002
11111111111111111111111120000002
11111111111111111111112220000002
11111111111111111111122000000002
11111111111111111111120000000002
11111111111111111111222220000002
