41111111111111111200021120000002
11111111111111112200022120000002
11111111111111112000002120000002
11111111111111122000002220000002
11111111111111120000000000000002
11111111111111120000000000000002
11111111111111120000000000000002
11111111111111220000000000000002
11111111111111200000000000000002
11111111111111200000000000000002
11111111111111200000002220000002
11111111111111200000022120000002
11111111111112200000221120000002
21111111111122000022211120000002
22211111112220000221111120000000
00222222222000002211111120000000
00000000000000022111111120000000
00000000000000021111111120000000
00000000000000021111111120000000
00000000000000021111111120000000
00000000000000021111111120000000
00000000000000021111111120000000
00000000000000021111111120000000
22222222222222221111111120000002
