41111111111111111111111120000002
11111111111111111111111120000002
11111111111111111111111120000002
22211111111111111111111120000002
00222111111111111111111120000000
00002111111111111111111120000000
00002211111111111111111120000000
00000211111111111111111120000000
00000211111111111111111120000000
00002211111111111111111120000000
00002111111111111111111120000000
00022111111111111111111120000000
02221111111111111111111120000000
22111111111111111111111120000002
11111111111111111111111120000002
11111111111111111111111120000002
11111111111111111111111120000002
11111111111111111111111120000002
11111111111111111111111120000002
11111111111111111111111120000002
11111111111111111111111120000002
11111111111111111111111120000002
11111111111111111111111120000002
11111111111111111111111120000002
