41111111111111111111111120000002
11111111111111111111111120000002
11111111111111111111111120000002
22222211111111111111111120000002
00000222111111111111111120000000
00000002211111111111111120000000
00000000211111111111111120000000
00000000221111111111111120000000
00000000021111111111111120000000
00000000021111111111111120000000
00000000022111111111111120000000
00000000002111111111111120000000
00000000002111111111111120000000
00000000002111111111111120000000
00000000002111111111111120000000
00000000002111111111111120000000
00000000002111111111111120000000
00000000002111111111111120000000
00000000002111111111111120000000
00000000002111111111111120000000
00000000002111111111111120000000
00000000002111111111111120000000
00000000002111111111111120000000
22222222222111111111111120000002
